1111111
1P00001
1C011C1
1000001
1111011
1C00E01
1111111
